S.###################################################################################################
..#...#.#.#...........#...#.....#.#.....#.#.......#.#.......#.........#.#.#...........#.#.......#...#
#.#.###.#.###########.###.###.###.#.###.#.#.#######.#.#########.#.###.#.#.###.#.#.###.#.#.#########.#
#.....#.........#.............#.#.#.#.....#...#.#.#.....#.#...#.#.#...........#.#.#.#.#.#.....#.#...#
#.#####.#.#####.#######.#######.#.#####.#.#.###.#.###.#.#.#.#.#.#####.#####.#.###.#.#.#.#####.#.###.#
#...#...#.#.....#.#...#.....#.........#.#.#...........#...#.#.......#.#.#.#.#...#.#...#...#.......#.#
#.#.#####.#######.#.#.#####.###.#.###.#.#.#######.###.#.###.#######.#.#.#.#####.#######.#.#.#.###.#.#
#.#.#.....#.#.#.#...#.#.........#.#.....#.#.#.#...#...#.....#...#...#.........#.....#...#...#.#.....#
###.###.#.#.#.#.###.#######.#########.#.###.#.#.###.#.###.###.#########.#####.#####.#.#############.#
#...#...#.............#...#.#.........#.#...#.#...#.#.#.#.#.............#.....#...........#.#.#.....#
#.###.###########.#######.#.###.#####.#.###.#.#######.#.#####.#.###.#.#####.#####.#####.#.#.#.#######
#.......#.#.#.#.......#...#.#...#.....#...#...#.#.#.....#.#.#.#.#.#.#.#.......#.......#.#.......#...#
###.#.###.#.#.#.#.#.#.#.#####.###.#######.###.#.#.###.###.#.#####.#.#######.#####.###.#####.#.#.###.#
#...#.#...#...#.#.#.#.#.....#.#...#.....#.............#.#.#...........#.#...#.......#.#.#...#.#.#...#
#.#.#.#.#####.#.#######.###.###.###.###########.#####.#.#.#######.###.#.#.###########.#.#.#.#######.#
#.#.#.#.#.....#...#...#.#.#.....#.....#...#.....#...#.........#...#.#.#.....#.#.......#.#.#.........#
#.#####.###.#.#####.###.#.#.#########.###.###.#.###.#.#######.#####.#########.###.#####.###.###.###.#
#...........#.#.....#.#.#...#...#...........#.#.#.#...#...#.........#.#...#...#.#.#.#.........#.#.#.#
#####.#######.###.###.###.#.###.#.#####.#.#.#####.#######.###.#######.###.###.#.###.#######.#####.#.#
#...#.......#...#.#.......#.....#.#...#.#.#.#...#...#.......#.....#.....#.....#.....#...#.....#...#.#
#.#####.#####.#.#.###.###.#####.#.#.#.#####.#.###.###.#.###.###########.#.#########.###.#####.#.#####
#.#.........#.#.......#.....#...#...#.#.#.....#.#.#...#...#...#...#.....#...#.......#.#.#.......#.#.#
#.#.#.#.###.###.#######.#####.#.#.#.#.#.###.###.#.#.###.###.#.###.#.###.#.#.#######.#.#.#.#.#####.#.#
#...#.#.#...#...#.#.........#.#...#.#.#.#.#...........#.#...#.....#.#.#...#...#.....#.....#.#.#.#...#
###.###.#.###.###.#########.###.#.#.###.#.#.###.###.###############.#.#.#.#.#.#.#####.###.###.#.#.###
#.#...#.#...#.......#.#.#.#...#.#.#...#...#...#.#.#.#.............#.#.#.#.#.#.#.........#.#...#.#...#
#.#####.###.#.#.###.#.#.#.###.#.#.#####.#####.###.#######.#####.###.#.###.#####.#.#.#####.#.#.#.#.###
#.........#.#.#.#.#.....#.#.#.#.#.#.....#.............#.#...#.......#.....#.....#.#.#...#...#.......#
#.###.#####.#####.#####.#.#.#.#########.###.#######.#.#.#####.#.#.###.###.#########.#.#.#######.###.#
#...#.#...........#.....#.........#.#...#.....#.#...#.#...#...#.#...#...#...#.#.......#.#.........#.#
#.#.#######.###########.#######.###.###.#.###.#.#.#####.#.###.#.#######.###.#.#.#####.#####.###.#####
#.#.......#.......#.......#.#...#.#.#...#...#.#.......#.#...#.#.....#...#.#.#.#.#.#...#...#.#.#.#...#
#.#######.#.###.#.#.#######.#.###.#.#.#.#.#.#.#####.###.#########.#.#.###.###.###.#####.###.#.#.#.###
#.#...#.#.#.#...#.#...#.#...#.....#...#...#.#.#.....#.......#.....#.#...#.#...#...#.......#...#.....#
#.#.###.#.#######.#####.#.###.###########.#.#.#####.#######.#########.#.#.#.###.#####.#####.#####.###
#.......#.#...#.#.....#.....#.#.#.#.#.....#.#.#.........#.#...#.....#.#.....#...........#...#.......#
###.#.#.###.#.#.#######.###.#.#.#.#.###.#######.#####.#.#.#.###.###.#.#.#####.#####.#.#####.#####.###
#...#.#.#...#.#...#...#...#.......#.....#.#.........#.#.#.#.....#.#.#.#.......#...#.#.....#.#.......#
#.###.###.###.###.#.###.#########.#.###.#.###.###########.###.###.#.#####.###.#.###.#.#.#####.###.#.#
#.#.#.#.#...#.#.#.....#.#.#.....#.#.#...#.......#.#...#.......#.#.........#.....#.#.#.#.#.....#...#.#
#.#.###.#.#.###.###.#####.#.#######.#.#######.###.#.#.#.#.#.###.#######.###.#.#.#.###.#####.#########
#...#.....#.#.#...............#.#.#.#.#.#.........#.#...#.#.#...#.#.#...#...#.#.#...#...#.#...#.....#
#####.#.###.#.#.#####.#.#.###.#.#.###.#.#.###.###.#########.#.#.#.#.###.###########.#####.#.#.#.#####
#.#.#.#...#...#...#...#.#...#.#.........#.#.#.#...#...........#.#...#.....#.#.#...........#.#.#.#...#
#.#.#####.#####.###.#######.#####.###.###.#.###.#####.#####.#######.#.###.#.#.###.#.#####.#####.#.###
#.#...........#...#.......#.#.#...#...#...#.......#.#...#.....#...#...#.#.#.#.#.#.#...#.#.#.#.......#
#.###.###.###.#.#####.#######.#####.###.#.#.#.###.#.#####.###.#.#.#.#.#.###.#.#.#####.#.#.#.#.#.#####
#...#.#.....#...#...#...#.....#...#.#...#.#.#.#.#.#...#.....#...#.#.#.....#...#.....#.#.......#.#...#
###.#####.#######.#######.#.#.#.#####.#####.#.#.#.#.###.#####.###############.#.#.#.#####.#####.#.###
#...#...#.........#.#.#...#.#...#...#.#.#...#...#.....#.#.......#.#.............#.#...#...#...#.#...#
###.###.###.###.###.#.###.#####.#.#.#.#.#.###.###.#####.#.###.###.#####.#.#####.###.###.#.#.#######.#
#.#...#...#...#...#.#.....#.#.....#.#.#.#...#.#.....#.#.#.#.#.....#.#...#.#.#.....#.#.#.#.....#.....#
#.###.###.#######.#.#####.#.#####.###.#.#.###.#######.#####.###.###.#####.#.#.#.#.###.#.###.###.#####
#.........#...#.#...#.......#...#.#.....#.#...........#.....#.....#.#...#...#.#.#.#.....#.#.#.#.#.#.#
###.#.#.#.#.###.###.#######.###.###.#.###########.###.#.#######.#.#.#.#.#.#.#.#########.#.#.#.#.#.#.#
#...#.#.#.#.#.#...#...........#...#.#...#.....#.....#.#.........#.....#...#.#.#.......#...#.....#.#.#
###.#####.#.#.#.###.#.###.#.#.#.#.#.#.#####.#####.#.###########.#####.###.#########.###########.#.#.#
#.....#.#.#.....#...#...#.#.#.#.#...#...#.....#...#.#.#.#...#.#.#.....#.......#...#...........#.....#
###.###.#######.###########.#.###.#.#######.#########.#.#.###.#####.#######.###.#####.#####.###.#.###
#.#.#.#.....#.#.....#.....#.#.#...#.#.#.#.......#...#.....#.#.#.#.....#.........#...#...#.#.....#.#.#
#.#.#.#####.#.#####.#.#.#####.#.#.###.#.#####.###.#####.#.#.#.#.#######.###.#####.#.###.#.#.###.###.#
#.#.#.#.....#.#...#.#.#...#.....#.....#.....#...........#...#.......#...#.....#...#...#.#...#...#...#
#.#.#.###.###.#.#.#.#####.#####.###.#.#.#.###.#.###.#.#########.###.#.#.###.#####.###########.#.#.###
#.......#.......#...#...#...#...#...#...#.#.#.#.#...#.....#...#...#...#.#.#.#.#.........#.....#...#.#
#####.#####.###.#.###.###.#####.#.#.###.###.#########.#####.###.#.#.#####.#.#.#######.#####.#######.#
#...#.#.......#.#.......#.#.....#.#.#.......#.......#.#...#...#.#.#.#.#.#.......................#...#
#.#.#.#.###.#######.###.#.#.#.###.###.#######.#####.#.###.#.#.#.#.###.#.#.###.#.###.#####.#.###.###.#
#.#.#...#...#...#...#.#...#.#...#.#...#.#.......#.....#...#.#.#.#.#.....#...#.#.#...#...#.#...#...#.#
#.#.###.#####.#.#####.#.###.#######.###.#.#.#########.###.#.#.#.###.#.#####.#######.#.###.#.#.#####.#
#.#.#...#...#.#.....#.....#.#.#.........#.#...#.#.#.#.......#.#.....#.#...#.......#.#.....#.#.#.....#
#.#.#####.#########.#.#######.###.#####.#######.#.#.#.###.###.#######.#.#####.###.#####.#.#######.###
#.#.........#...#.#...#...#.#...#.....#...#...#.......#...#.....#.#.#.#.....#.#.#.....#.#.....#.#...#
#####.#######.###.###.#.###.###.###.#####.#.###.#.###.#.#####.###.#.###.#.#.#.#.#.#######.###.#.#.#.#
#.........#.....#.#...#.#...#.......#.....#.....#...#.#.#.#.......#...#.#.#.....#.#.....#...#.#...#.#
#.#.###.#.#.###.#.###.#.#.#####.###.###.#####.#######.###.###.###.#.#####.###.#.#.#####.#####.#.#####
#.#...#.#...#.....#.....#.........#.#...#...#.....#.#...#.#.#...#...#.#.#.#.#.#.#.#.#.....#.#.#.....#
#.#.#.#.#####.#.#.###.#################.#.###.#.###.#.###.#.###.#.#.#.#.###.#.#####.###.###.#.#.###.#
#.#.#.#...#...#.#.......#.......#.....#.#.#...#...#...#.........#.#.#.#.#...............#.........#.#
###.#######.#.#####.###.#.#.#.###.###.#.#.#.#.#.#####.#.###.###.#.#.#.#.#.#####.#.#######.#.#####.###
#.#...#.....#.#.....#.....#.#.#...#.....#.#.#.#.....#.#.#.#...#.#.#.....#.#.#...#.#.....#.#...#.....#
#.#.#.#########.###.###.###.#####.#.#.#.#.#.#####.#.#.###.###.#.#.#########.#####.###.#.###.###.#####
#.#.#...#.........#.#.#...#.#.#.#.#.#.#.#...#...#.#.#.#...#...#.#.#.#.........#.#...#.#.....#.......#
#.#########.#######.#.#####.#.#.#.#.#.###.###.###.###.###.#.#####.#.#######.#.#.###.###.#####.#.#####
#.#.#...........#...#.#.......#.#.#.#.....#...#...#.....#...#...#.#.#.#.#.#.#.#.#.#...#.#.....#...#.#
#.#.###########.#.###.###.#.#.#.###.#######.#######.#####.###.#.###.#.#.#.###.#.#.#####.#.###.#####.#
#.....#.........#.....#...#.#.....#.........#.#.......#...#...#.....#...#...#.#.....#...#.#.....#.#.#
#.#######.#.#########.###.#.###.#############.#.#####.###.#.###.###.###.#.#.#.#.#.#####.#####.###.#.#
#...#.....#...#.#.#...#...#...#.....#.....#.....#.....#.#.#.#...#.#.......#.#...#...#.#.#.#.#.....#.#
#.###.#.#####.#.#.#.#.#.#.#######.#.#.#.###.###.#######.#.#.###.#.###.#####.#.#.#.###.###.#.###.#.#.#
#.....#.#...#.#.....#.#.#.#.....#.#.#.#.#.#...#.....#.......#...#.#...#.#.#...#.#.#...#.#.#.....#.#.#
#.#.#.###.###.#####.###.#######.###.#.###.#########.#####.#######.#.#.#.#.#####.###.#.#.#.#######.#.#
#.#.#.#.#.....#...#.#.#.#...#...#.........#...#.#.#.#.#.......#.....#.....#.#.......#...............#
###.#.#.###.#.###.#.#.#.#.#.#.###.#######.###.#.#.###.#.#.#####.#.###.#####.#.#######.###.###.#####.#
#...#...#.#.#.#.......#...#.#.....#...#.#.....#.#...#...#.#.#.#.#.#.#.....#.....#.#...#...#...#...#.#
#.#######.#.#######.#########.#.#.###.#.#.#.###.#.#####.#.#.#.###.#.###.###.#.###.#.#########.#.###.#
#...#...#.....#...........#.#.#.#.#.......#...#.#.....#.#...#.#.#.#...#.#...#.....#.#...#.........#.#
#.#.###.#.#######.#####.#.#.#.###.###.###.#.###.#.#.#.###.###.#.#####.#.#####.#.#####.#.###.#########
#.#.#...#.#.....#.#...#.#.#.....#.#.....#.#.......#.#.........#.#...#.#.....#.#...#...#.#...........#
#.#.#.#.#######.#.#.###########.###.#.###.#.#####.###.#.#####.#.#.###.###.#.###.#.#####.###.#######.#
#.#...#...#...................#.#...#...#.#.....#...#.#.....#.......#.....#.#...#.#...........#......
###################################################################################################.E
